111111111111111111111
1        1 1       01
111111111111        1
           1   N    1
111111111111111111111